TFTFTFTFTFFFTTFFTTFFTTTTTTFFFF
Azrin, Neil
FFTFTFTFFFFFTFTFTTFFTTTTTTFFTF
Babbage, Charles
FFFTFFFTTTFFFTTFTTTFTFTTFTFFFF
Boole, George
TTTFFFTDTFFFFTFFTFFFFTTTTTTFFF
Burks, Arthur
FFTFTTTFFFFTTTFTTTFTTTTFTTTFFT
Crick, Francis
TFTFTFTFTFTTFFTTFFTTTTTTTTTTTT
Curie, Marie
FFFFFFTTTFTFFTFTTTTFFFFFTTFTFF
Einstein, Albert
TFTFTFTFTFFFTTFFTTFFTTTTTTFFFF
Franklin, Rosalyn
TFTFFFTFTFTFTTFFFTFFTTFTTTFFFF
Heisenberg, Werner
TFTTFTFTFTTTFFTTFFTTFFFFFFTTTT
Hofstadter, Douglas
TFTFTFTFTFFFTTFFTrFFFTTTTTFFFF
Krieger, Dorothy
FTFTFTFTFTTTTTFFTTFFTTTTTTFFFF
Mead, Margaret
FTTFTFTFFFFTTTFFFTFFFTTTTFFFFF
Minsky, Marvin
FFFFFFFFFFFTTFFTTFFTFFTTTTFFFF
Newton, Isaac
FFFFTFTFTFFFTTFFTTTFTTTTTTFFFT
Olsen, Catherine
TFTFTFTFTFFFTTFFTTFFTTTTTTFFFF
Pascal, Blaise
TFTFFTTFFTFFTTTFTTTFTFTTTFFFFF
Pylyshyn, Zenon
FTFTFTFTFTFFTTFFTTFFFFFFTTFFFF
Ritchie, Dennis
TFFFTFTFTFFFFTFFTTFFTTFTTTFFFF
Sagan, Carl
FTFTFTFTFFTTFFTTFFTTTFFFFFTTTT
Schroedinger, Erwin
TTTFFFTTTTTFTFFFFTFTFFTTTTTTFF
Skinner, B.F.
FTFTFTTFTFTTFFTTFFTTFFFFFFTTTT
Turing, Alan
TTTFTFTTTFTFTTFFTFFFTFTTTTTFFF
Van Allen, James
TFTFTFTFTFFFTTFFTTTTFFFFFFTTTT
Von Neumann, John
FFTFTFFFTFFFTTFTTTFFTTTTFTFFFF
Watson, James
FTFTFTFTFTTTFFTTFFTTFFFFFFTTTF